[console_scripts]
buildcff2vf = afdko.buildcff2vf:main
buildmasterotfs = afdko.buildmasterotfs:main
comparefamily = afdko.comparefamily:main
checkoutlinesufo = afdko.checkoutlinesufo:main
makeotf = afdko.makeotf:main
makeinstancesufo = afdko.makeinstancesufo:main
otc2otf = afdko.otc2otf:main
otf2otc = afdko.otf2otc:main
otf2ttf = afdko.otf2ttf:main
ttfcomponentizer = afdko.ttfcomponentizer:main
ttfdecomponentizer = afdko.ttfdecomponentizer:main
ttxn = afdko.ttxn:main
charplot = afdko.proofpdf:charplot
digiplot = afdko.proofpdf:digiplot
fontplot = afdko.proofpdf:fontplot
fontplot2 = afdko.proofpdf:fontplot2
fontsetplot = afdko.proofpdf:fontsetplot
hintplot = afdko.proofpdf:hintplot
waterfallplot = afdko.proofpdf:waterfallplot
detype1 = afdko._internal:detype1
addfeatures = afdko._internal:addfeatures
mergefonts = afdko._internal:mergefonts
rotatefont = afdko._internal:rotatefont
sfntdiff = afdko._internal:sfntdiff
sfntedit = afdko._internal:sfntedit
spot = afdko._internal:spot
tx = afdko._internal:tx
type1 = afdko._internal:type1
otfautohint = afdko.otfautohint.__main__:main
otfstemhist = afdko.otfautohint.__main__:stemhist

